{
  "short": [
    [ 0, 0 ],
    [ 0, 2 ],
    [ 0, 4 ],
    [ 0, 7 ],
    [ 0, 9 ],
    [ 3, 0 ],
    [ 3, 2 ],
    [ 3, 3 ],
    [ 3, 4 ],
    [ 3, 5 ],
    [ 3, 7 ],
    [ 3, 9 ],
    [ 6, 0 ],
    [ 6, 2 ],
    [ 6, 3 ],
    [ 6, 5 ],
    [ 6, 7 ],
    [ 6, 9 ],
    [ 9, 0 ],
    [ 9, 2 ],
    [ 9, 4 ],
    [ 9, 5 ],
    [ 9, 6 ],
    [ 9, 7 ],
    [ 9, 9 ],
    [ 12, 0 ],
    [ 12, 2 ],
    [ 12, 4 ],
    [ 12, 6 ],
    [ 12, 9 ]
  ],
  "longLeft": [],
  "longRight": [],
  "ladder": []
}